qh	xfbm
广东省	广东省信访局
东城街道	东莞市东城街道办事处信访办公室
南城街道	东莞市南城街道办事处信访办公室
万江街道	东莞市万江街道办事处信访办公室
莞城街道	东莞市莞城街道办事处信访办公室
石碣镇	东莞市石碣镇人民政府信访办公室
石龙镇	东莞市石龙镇人民政府信访办公室
茶山镇	东莞市茶山镇人民政府信访办公室
石排镇	东莞市石排镇人民政府信访办公室
企石镇	东莞市企石镇人民政府信访办公室
横沥镇	东莞市横沥镇人民政府信访办公室
桥头镇	东莞市桥头镇人民政府信访办公室
谢岗镇	东莞市谢岗镇人民政府信访办公室
光明区	光明区信访局
河源市	河源市信访局
高要区	肇庆市高要区信访局
高新区	肇庆高新区信访局
坦洲镇	中山市坦洲镇人民政府信访办公室
东坑镇	东莞市东坑镇人民政府信访办公室
常平镇	东莞市常平镇人民政府信访办公室
寮步镇	东莞市寮步镇人民政府信访办公室
樟木头镇	东莞市樟木头镇人民政府信访办公室
大朗镇	东莞市大朗镇人民政府信访办公室
黄江镇	东莞市黄江镇人民政府信访办公室
清溪镇	东莞市清溪镇人民政府信访办公室
塘厦镇	东莞市塘厦镇人民政府信访办公室
凤岗镇	东莞市凤岗镇人民政府信访办公室
大岭山镇	东莞市大岭山镇人民政府信访办公室
长安镇	东莞市长安镇人民政府信访办公室
虎门镇	东莞市虎门镇人民政府信访办公室
厚街镇	东莞市厚街镇人民政府信访办公室
沙田镇	东莞市沙田镇人民政府信访办公室
道滘镇	东莞市道滘镇人民政府信访办公室
洪梅镇	东莞市洪梅镇人民政府信访办公室
麻涌镇	东莞市麻涌镇人民政府信访办公室
望牛墩镇	东莞市望牛墩镇人民政府信访办公室
中堂镇	东莞市中堂镇人民政府信访办公室
高埗镇	东莞市高埗镇人民政府信访办公室
松山湖高新技术产业开发区	松山湖高新技术产业开发区管理委员会
南山区	南山区信访局
源城区	源城区信访局
龙华区	龙华区信访局
江东新区	江东新区综治中心
东源县	东源县信访局
深汕特别合作区	深圳市深汕特别合作区应急管理局
梅江区	梅州市梅江区信访局
和平县	和平县信访局
云浮市	云浮市信访局
五桂山	中山市人民政府五桂山办事处信访办公室
紫金县	紫金县府办信访工作组
湛江市	湛江市信访局
云城区	云浮市云城区信访局
连平县	连平县信访局
云安区	云浮市云安区信访局
龙川县	龙川县信访局
罗定市	罗定市信访局
东凤镇	中山市东凤镇人民政府信访办公室
新兴县	新兴县信访局
惠东县	惠东县信访事务中心
惠州市	惠州市信访局
郁南县	郁南县信访局
从化区	从化区信访局
肇庆市	肇庆市信访局
板芙镇	中山市板芙镇人民政府信访办公室
东区	中山市东区社会治安综合治理和维护稳定办公室
阜沙镇	中山市阜沙镇人民政府信访办公室
博罗县	博罗县信访局
黄埔区	黄埔区信访局
端州区	端州区信访局
惠阳区	惠阳区司法和信访局
江门市	江门市信访局
鼎湖区	鼎湖区信访局
三角镇	中山市三角镇信访办公室
遂溪县	遂溪县信访局
徐闻县	徐闻县信访局
廉江市	廉江市信访局
吴川市	吴川市信访局
南朗镇	中山市南朗镇信访办公室
四会市	四会市信访局
蓬江区	江门市蓬江区信访局
广宁县	广宁县信访局
阳江市	阳江市信访局
江海区	江门市江海区信访局
德庆县	德庆县信访局
新会区	新会区信访局
封开县	封开县信访局
大涌镇	中山市大涌镇人民政府信访办公室
怀集县	怀集县信访局
阳春市	阳春市信访局
台山市	台山市信访局
开平市	开平市信访局
横栏镇	中山市横栏镇人民政府信访办公室
珠海市	珠海市信访局
鹤山市	鹤山市信访局
恩平市	恩平市信访局
阳东区	阳东区信访局
信宜市	信宜市信访局
江城区	江城区信访局
横琴新区	横琴新区信访办
高州市	高州市信访局
香洲区	香洲区信访局
阳西县	阳西县信访局
坡头区	坡头区信访局
金湾区	珠海市金湾区信访局
石岐区	中山市石岐区人民政府信访办公室
梅州市	梅州市信访局
高新区	阳江高新技术产业开发区综治信访维稳中心
潮州市	潮州市信访局
海陵岛经济开发试验区	阳江市海陵岛经济开发试验区信访局
高栏港经济区	高栏港经济区信访办
枫溪区	枫溪区信访局
潮安区	潮州市潮安区信访局
高新技术开发区	高新区信访办
兴宁市	兴宁市信访局
湘桥区	湘桥区信访局
饶平县	饶平县信访局
荔湾区	荔湾区信访局
保税区	保税区信访办
万山海洋开发试验区	万山海洋开发试验区信访办公室
东莞市	东莞市信访局
揭阳市	揭阳市信访局
梅县区	梅州市梅县区信访局
大埔县	大埔县信访局
丰顺县	丰顺县信访局
惠来县	惠来县信访局
小榄镇	中山市小榄镇信访办公室
红海湾经济开发区	汕尾市红海湾区信访局
华侨管理区	汕尾市华侨管理区信访局
五华县	五华县信访局
揭东区	揭东区信访局
揭西县	揭西县信访局
平远县	平远县信访局
三乡镇	中山市三乡镇人民政府信访办公室
揭阳产业转移工业园	揭阳产业转移工业园信访局
东升镇	中山市东升镇人民政府信访办公室
蕉岭县	蕉岭县信访局
空港经济区	空港区信访局
清远市	清远市信访局
滨海湾新区	东莞滨海湾新区管委会信访办公室
普宁市	普宁市信访局
清城区	清城区信访局
榕城区	榕城区信访局
城区	汕尾市城区信访局
清新区	清远市清新区信访局
海丰县	海丰县信访局
盐田区	深圳市盐田区信访局
大鹏新区	深圳市大鹏新区政法办公室
英德市	英德市信访局
龙门县	龙门县信访局
番禺区	番禺区信访局
陆丰市	陆丰市信访局
连州市	清远市连州市信访局
佛冈县	佛冈县信访局
陆河县	陆河县信访局
赤坎区	赤坎区信访局
连山壮族瑶族自治县	连山壮族瑶族自治县信访局
连南瑶族自治县	连南瑶族自治县信访局
霞山区	湛江市霞山区信访局
汕尾市	汕尾市信访局
阳山县	阳山县信访局
汕头市	汕头市信访局
大亚湾区	惠州市大亚湾区信访局
雷州市	雷州市信访局
天河区	天河区信访局
白云区	白云区信访局
神湾镇	中山市神湾镇人民政府信访办公室
金平区	金平区信访局
西区	中山市人民政府西区办事处信访办公室
黄圃镇	中山市黄圃镇人民政府信访办公室
龙湖区	龙湖区信访局
澄海区	澄海区信访局
民众镇	中山市民众镇人民政府信访办公室
濠江区	濠江区信访局
潮阳区	潮阳区信访局
潮南区	潮南区信访局
南澳县	南澳县信访局
韶关市	韶关市信访局
沙溪镇	中山市沙溪镇人民政府信访办公室
古镇镇	中山市古镇镇人民政府信访办公室
浈江区	浈江区信访局
开发区	中山市火炬开发区人民政府信访办公室
武江区	武江区信访局
曲江区	曲江区信访局
乐昌市	乐昌市信访局
中山市	中山市信访局
南雄市	南雄市信访局
南区	中山市南区办事处信访办公室
南头镇	中山市南头镇人民政府
斗门区	珠海市斗门区信访局
仁化县	仁化县信访局
越秀区	越秀区信访局
始兴县	始兴县信访局
惠城区	惠州市惠城区信访局
广州市	广州市信访局
翁源县	翁源县信访局
新丰县	新丰县信访局
乳源瑶族自治县	乳源瑶族自治县信访局
茂名市	茂名市信访局
深圳市	深圳市信访局
佛山市	佛山市信访局
花都区	花都区信访局
滨海新区	滨海新区政法和社会工作局
电白区	电白区信访局
禅城区	禅城区信访局
福田区	福田区信访局
港口镇	中山市港口镇人民政府信访办公室
增城区	增城区信访局
南海区	佛山市南海区信访局
罗湖区	罗湖区信访局
化州市	化州市信访局
海珠区	海珠区信访局
高新区	茂名高新区政法和社会事务局
龙岗区	龙岗区信访局
茂南区	茂南区信访局
顺德区	顺德区信访局
湛江经济技术开发区	湛江经济技术开发区信访局
宝安区	宝安区信访局
仲恺区	仲恺区信访局
高明区	高明区信访局
坪山区	坪山区信访局
南沙区	广州市南沙区信访局
三水区	佛山市三水区信访局
麻章区	麻章区信访局
